"","urban_area","total_population","labor_force","unemployed_Workers","not_in_labor_force","total_population_over_16","urban_area.1","employment_rate","labor_force_participation_rate"
"247","Mayaguez, PR Urbanized Area (2010)",99192,31674,7833,51929,83603,"55738",0.75,0.378862002559717
"124","Fajardo, PR Urbanized Area (2010)",79513,31475,7518,32494,63969,"28981",0.76,0.492035204552205
"189","Juana Diaz, PR Urbanized Area (2010)",71765,28311,6286,28914,57225,"43453",0.78,0.494731323722149
"433","Yauco, PR Urbanized Area (2010)",78110,23558,4382,39506,63064,"97561",0.81,0.373557021438539
"4","Aguadilla--Isabela--San Sebastian, PR Urbanized Area (2010)",280302,92382,16940,140341,232723,"00631",0.82,0.396961194209425
"363","Sebring--Avon Park, FL Urbanized Area (2010)",69970,24814,4075,32778,57592,"80416",0.84,0.430858452562856
"348","San Juan, PR Urbanized Area (2010)",1979626,792976,125517,834972,1627948,"79093",0.84,0.487101553612278
"154","Guayama, PR Urbanized Area (2010)",70736,22134,3270,34635,56769,"35866",0.85,0.389895893885748
"250","Merced, CA Urbanized Area (2010)",143655,63514,9506,43288,106802,"56251",0.85,0.59468923802925
"132","Florida--Imbery--Barceloneta, PR Urbanized Area (2010)",71931,22805,3166,36420,59225,"30115",0.86,0.385056986070072
"113","El Centro--Calexico, CA Urbanized Area (2010)",113506,47257,6484,35535,82792,"26416",0.86,0.570791863948208
"6","Albany, GA Urbanized Area (2010)",93386,43739,5985,26612,70351,"00901",0.86,0.621725348609117
"302","Ponce, PR Urbanized Area (2010)",131749,41322,5351,67727,109049,"70642",0.87,0.378930572494933
"165","Hemet, CA Urbanized Area (2010)",184423,70747,8869,67965,138712,"38215",0.87,0.510027971624661
"407","Victorville--Hesperia, CA Urbanized Area (2010)",340982,136836,16259,117503,254339,"90541",0.88,0.538006361588274
"129","Flint, MI Urbanized Area (2010)",346311,156091,18359,117391,273482,"29872",0.88,0.570754199545125
"239","Madera, CA Urbanized Area (2010)",84600,36104,4509,24032,60136,"52984",0.88,0.600372489024877
"282","Odessa, TX Urbanized Area (2010)",141261,71304,8238,32560,103864,"64864",0.88,0.68651313255796
"346","San German--Cabo Rojo--Sabana Grande, PR Urbanized Area (2010)",112496,33180,3681,60141,93321,"78985",0.89,0.355546982994181
"304","Porterville, CA Urbanized Area (2010)",70463,26620,2937,24342,50962,"71074",0.89,0.522349986264275
"381","Stockton, CA Urbanized Area (2010)",395975,176691,19908,120362,297053,"85087",0.89,0.594813046830027
"382","Sumter, SC Urbanized Area (2010)",72852,34789,3964,22052,56841,"85708",0.89,0.612040604493235
"259","Modesto, CA Urbanized Area (2010)",376356,171932,18899,108427,280359,"58006",0.89,0.61325657460613
"31","Bakersfield, CA Urbanized Area (2010)",561917,256570,27383,151589,408159,"04681",0.89,0.62860306890207
"22","Arecibo, PR Urbanized Area (2010)",125675,39424,3973,64900,104324,"03034",0.9,0.377899620413328
"19","Anniston--Oxford, AL Urbanized Area (2010)",77916,35374,3605,27305,62679,"02629",0.9,0.5643676510474
"26","Atlantic City, NJ Urbanized Area (2010)",249860,127146,12581,76681,203827,"03898",0.9,0.623793707408734
"187","Jonesboro, AR Urbanized Area (2010)",70040,34738,3304,20943,55681,"43345",0.9,0.623875289596092
"327","Rockford, IL Urbanized Area (2010)",284585,143324,13996,83131,226455,"75718",0.9,0.632902784217615
"415","Waterbury, CT Urbanized Area (2010)",192420,98799,9484,54434,153233,"92485",0.9,0.64476320374854
"170","Homosassa Springs--Beverly Hills--Citrus Springs, FL Urbanized Area (2010)",83983,29351,2525,40696,70047,"39758",0.91,0.419018658900453
"55","Bristol--Bristol, TN--VA Urbanized Area (2010)",68138,30094,2811,26469,56563,"10351",0.91,0.532043915633895
"243","Mansfield, OH Urbanized Area (2010)",73819,32556,3017,28235,60791,"54091",0.91,0.535539800299386
"388","Texarkana--Texarkana, TX--AR Urbanized Area (2010)",79077,33382,2847,28787,62169,"87193",0.91,0.536955717479773
"437","Yuma, AZ--CA Urbanized Area (2010)",135437,56916,5228,48815,105731,"98020",0.91,0.538309483500582
"177","Indio--Cathedral City, CA Urbanized Area (2010)",366014,163817,14348,136203,300020,"41347",0.91,0.546020265315646
"332","Saginaw, MI Urbanized Area (2010)",121817,56146,4828,42664,98810,"77149",0.91,0.568221839894748
"36","Bay City, MI Urbanized Area (2010)",69712,33019,2866,23759,56778,"05869",0.91,0.581545669097186
"99","Decatur, IL Urbanized Area (2010)",89587,42357,4011,29429,71786,"22717",0.91,0.590045412754576
"157","Hammond, LA Urbanized Area (2010)",77310,35476,3100,24293,59769,"36514",0.91,0.5935518412555
"231","Lorain--Elyria, OH Urbanized Area (2010)",181611,88197,7936,58783,146980,"51364",0.91,0.600061232820792
"436","Yuba City, CA Urbanized Area (2010)",121165,55228,5007,36463,91691,"97939",0.91,0.60232738218582
"397","Turlock, CA Urbanized Area (2010)",105948,48962,4475,31639,80601,"89083",0.91,0.607461445887768
"139","Fresno, CA Urbanized Area (2010)",693179,317691,28524,199858,517549,"31843",0.91,0.613837530359444
"222","Lima, OH Urbanized Area (2010)",72286,35266,3316,21440,56706,"49852",0.91,0.621909498113074
"389","Texas City, TX Urbanized Area (2010)",119398,57013,5292,34144,91157,"87220",0.91,0.625437432122602
"146","Grand Junction, CO Urbanized Area (2010)",132281,66811,6174,39083,105894,"34273",0.91,0.630923376206395
"74","Chico, CA Urbanized Area (2010)",105429,54835,4909,31539,86374,"16318",0.91,0.634855396299812
"126","Fayetteville, NC Urbanized Area (2010)",329517,161278,13813,89403,250681,"29440",0.91,0.643359488752638
"269","Nampa, ID Urbanized Area (2010)",166214,78371,6969,42552,120923,"60976",0.91,0.648106646378274
"405","Vallejo, CA Urbanized Area (2010)",175022,91935,7863,49868,141803,"90028",0.91,0.64832901983738
"114","Elizabethtown--Radcliff, KY Urbanized Area (2010)",73846,37237,3353,19922,57159,"26750",0.91,0.651463461572106
"128","Flagstaff, AZ Urbanized Area (2010)",78102,43512,3777,22431,65943,"29818",0.91,0.659842591328875
"164","Hattiesburg, MS Urbanized Area (2010)",79310,42072,3787,21686,63758,"37594",0.91,0.659870133943976
"218","Leesburg--Eustis--Tavares, FL Urbanized Area (2010)",144087,55118,4601,66992,122110,"48799",0.92,0.451379903365818
"56","Brownsville, TX Urbanized Area (2010)",230844,88639,7422,77976,166615,"10972",0.92,0.531998919665096
"210","Lancaster--Palmdale, CA Urbanized Area (2010)",353643,142165,11000,120133,262298,"47611",0.92,0.541998032771885
"179","Jackson, MI Urbanized Area (2010)",89300,38736,3134,32180,70916,"42157",0.92,0.546223701280388
"264","Muncie, IN Urbanized Area (2010)",88283,42333,3494,32825,75158,"60625",0.92,0.563253412810346
"101","Deltona, FL Urbanized Area (2010)",201009,94613,7339,71983,166596,"23311",0.92,0.56791879757017
"315","Pueblo, CO Urbanized Area (2010)",140031,63733,5175,48340,112073,"72613",0.92,0.568673989274848
"435","Youngstown, OH--PA Urbanized Area (2010)",370731,173623,13679,130783,304406,"97831",0.92,0.570366549936598
"305","Port Huron, MI Urbanized Area (2010)",86053,40561,3179,30341,70902,"71155",0.92,0.572071309695072
"166","Hickory, NC Urbanized Area (2010)",213562,100743,8529,71922,172665,"38647",0.92,0.583459299800191
"408","Vineland, NJ Urbanized Area (2010)",93078,42794,3280,30157,72951,"90730",0.92,0.586612931968033
"395","Tucson, AZ Urbanized Area (2010)",869249,420921,32776,283873,704794,"88732",0.92,0.597225572294883
"213","Las Cruces, NM Urbanized Area (2010)",132107,62653,5321,41500,104153,"47935",0.92,0.601547723061266
"206","Lake Charles, LA Urbanized Area (2010)",148836,70016,5372,46157,116173,"46531",0.92,0.60268737142021
"107","Dover, DE Urbanized Area (2010)",118712,56630,4339,36944,93574,"24580",0.92,0.605189475709064
"267","Muskegon, MI Urbanized Area (2010)",164004,78074,5926,50863,128937,"60841",0.92,0.605520525527971
"285","Olympia--Lacey, WA Urbanized Area (2010)",188340,95122,7313,60608,155730,"65242",0.92,0.610813587619598
"400","Tyler, TX Urbanized Area (2010)",141003,66012,5137,41794,107806,"89326",0.92,0.612322134204033
"252","Middletown, OH Urbanized Area (2010)",97502,47053,3577,29566,76619,"56926",0.92,0.614116602931388
"217","Lebanon, PA Urbanized Area (2010)",80927,40066,3015,25114,65180,"48664",0.92,0.614697760049095
"274","New Bedford, MA Urbanized Area (2010)",150675,74664,5611,46428,121092,"61786",0.92,0.616589039738381
"152","Greenville, NC Urbanized Area (2010)",125564,62740,5308,38793,101533,"35380",0.92,0.617927176386003
"323","Riverside--San Bernardino, CA Urbanized Area (2010)",2073652,974917,78637,597640,1572557,"75340",0.92,0.619956542115803
"263","Mount Vernon, WA Urbanized Area (2010)",68550,33680,2652,20389,54069,"60490",0.92,0.6229077660027
"120","Eugene, OR Urbanized Area (2010)",262036,135768,10896,82185,217953,"28117",0.92,0.622923290801228
"266","Murrieta--Temecula--Menifee, CA Urbanized Area (2010)",493787,233210,18909,138763,371973,"60799",0.92,0.626954106884102
"92","Dalton, GA Urbanized Area (2010)",85962,41328,3196,24484,65812,"22069",0.92,0.627970582872424
"340","Salisbury, MD--DE Urbanized Area (2010)",104517,52839,4384,30264,83103,"78364",0.92,0.635825421464929
"244","Manteca, CA Urbanized Area (2010)",90106,43436,3506,24829,68265,"54145",0.92,0.636285065553358
"370","Slidell, LA Urbanized Area (2010)",94136,48027,3801,27418,75445,"82468",0.92,0.636582941215455
"87","Concord, NC Urbanized Area (2010)",230050,115918,9168,63675,179593,"19558",0.92,0.645448319255205
"211","Lansing, MI Urbanized Area (2010)",321812,171248,13338,93826,265074,"47719",0.92,0.646038464730604
"155","Gulfport, MS Urbanized Area (2010)",228121,115327,9319,62743,178070,"35920",0.92,0.647649800640198
"358","Savannah, GA Urbanized Area (2010)",284298,150469,11497,75690,226159,"79768",0.92,0.66532395350174
"180","Jackson, MS Urbanized Area (2010)",356131,185413,14721,92399,277812,"42211",0.92,0.667404575756267
"328","Rock Hill, SC Urbanized Area (2010)",110435,59064,4508,27487,86551,"75745",0.92,0.682418458481127
"207","Lake Jackson--Angleton, TX Urbanized Area (2010)",79757,40628,3092,18199,58827,"46801",0.92,0.690635252520101
"197","Killeen, TX Urbanized Area (2010)",233580,121260,9947,52414,173674,"44992",0.92,0.698204682335871
"379","Spring Hill, FL Urbanized Area (2010)",162074,60306,4178,74111,134417,"84024",0.93,0.448648608434945
"279","North Port--Port Charlotte, FL Urbanized Area (2010)",193362,75160,5512,91103,166263,"63838",0.93,0.452054876911881
"260","Monroe, LA Urbanized Area (2010)",115781,45775,3431,42762,88537,"58330",0.93,0.517015485051447
"181","Jackson, TN Urbanized Area (2010)",71000,30068,2053,26592,56660,"42265",0.93,0.530674196964349
"430","Winter Haven, FL Urbanized Area (2010)",225577,95262,6876,82903,178165,"96697",0.93,0.534684141105155
"173","Huntington, WV--KY--OH Urbanized Area (2010)",203162,89321,6079,75999,165320,"40753",0.93,0.540291555770627
"198","Kingsport, TN--VA Urbanized Area (2010)",109600,49637,3428,41152,90789,"45235",0.93,0.546729229311921
"9","Alexandria, LA Urbanized Area (2010)",80978,35485,2346,29196,64681,"01279",0.93,0.548615513056384
"238","Macon, GA Urbanized Area (2010)",134911,57659,3787,47335,104994,"52822",0.93,0.549164714174143
"16","Anderson, IN Urbanized Area (2010)",85800,39502,2733,31276,70778,"02386",0.93,0.558111277515612
"160","Harlingen, TX Urbanized Area (2010)",139643,57463,4170,45483,102946,"36892",0.93,0.55818584500612
"268","Myrtle Beach--Socastee, SC--NC Urbanized Area (2010)",260815,123536,8326,97710,221246,"60895",0.93,0.558364896992488
"42","Binghamton, NY--PA Urbanized Area (2010)",157909,74515,5383,56972,131487,"07732",0.93,0.566710016959852
"63","Carbondale, IL Urbanized Area (2010)",68740,32217,2387,24389,56606,"13591",0.93,0.569144613645197
"106","Dothan, AL Urbanized Area (2010)",71909,32096,2399,24217,56313,"24472",0.93,0.569957203487649
"236","McAllen, TX Urbanized Area (2010)",796635,322415,22753,237967,560382,"52390",0.93,0.575348601489698
"410","Visalia, CA Urbanized Area (2010)",226708,96673,6411,69843,166516,"90946",0.93,0.580562828797233
"423","Wheeling, WV--OH Urbanized Area (2010)",81108,39068,2732,28048,67116,"94726",0.93,0.582096668454616
"289","Owensboro, KY Urbanized Area (2010)",73207,33652,2236,23974,57626,"66484",0.93,0.583972512407594
"167","High Point, NC Urbanized Area (2010)",181326,84959,5561,58498,143457,"38809",0.93,0.592226242009801
"131","Florence, SC Urbanized Area (2010)",88576,43096,3101,29188,72284,"30061",0.93,0.596203862542195
"262","Morgantown, WV Urbanized Area (2010)",75340,39866,2917,26137,66003,"59275",0.93,0.604002848355378
"119","Erie, PA Urbanized Area (2010)",190927,93444,6200,61177,154621,"27766",0.93,0.604342230356808
"46","Bloomington, IN Urbanized Area (2010)",113392,60472,4045,39158,99630,"08380",0.93,0.606965773361437
"378","Springfield, OH Urbanized Area (2010)",83729,41331,2999,26140,67471,"83980",0.93,0.61257429117695
"376","Springfield, MA--CT Urbanized Area (2010)",626676,319674,21500,200347,520021,"83926",0.93,0.614732866557312
"84","Columbus, GA--AL Urbanized Area (2010)",262516,126058,9031,78968,205026,"19099",0.93,0.614839093578375
"28","Augusta-Richmond County, GA--SC Urbanized Area (2010)",415157,199112,14931,124175,323287,"04222",0.93,0.615898566908041
"105","Detroit, MI Urbanized Area (2010)",3725215,1858104,131686,1125814,2983918,"23824",0.93,0.622706119940293
"142","Gastonia, NC--SC Urbanized Area (2010)",176831,87890,6584,52881,140771,"32653",0.93,0.624347344268351
"365","Sherman, TX Urbanized Area (2010)",69151,34385,2412,20607,54992,"81631",0.93,0.62527276694792
"276","New Orleans, LA Urbanized Area (2010)",962389,484645,32763,288767,773412,"62677",0.93,0.6266323770513
"375","Springfield, IL Urbanized Area (2010)",161193,81185,5892,47738,128923,"83899",0.93,0.629716962838283
"296","Peoria, IL Urbanized Area (2010)",266814,134049,9938,78228,212277,"68509",0.93,0.631481507652737
"398","Tuscaloosa, AL Urbanized Area (2010)",153687,79233,5818,45538,124771,"89110",0.93,0.6350273701421
"61","Canton, OH Urbanized Area (2010)",277134,141891,9375,81510,223401,"13375",0.93,0.635140397760082
"432","Yakima, WA Urbanized Area (2010)",137363,64757,4614,36906,101663,"97507",0.93,0.636977071304211
"394","Trenton, NJ Urbanized Area (2010)",293892,152125,11325,86657,238782,"88462",0.93,0.637087385146284
"319","Reading, PA Urbanized Area (2010)",273538,136616,9080,76879,213495,"73693",0.93,0.639902573830769
"249","Memphis, TN--MS--AR Urbanized Area (2010)",1074600,533460,37445,299154,832614,"56116",0.93,0.640705056604861
"20","Antioch, CA Urbanized Area (2010)",304063,150726,10448,83855,234581,"02683",0.93,0.6425328564547
"384","Tallahassee, FL Urbanized Area (2010)",253709,137352,9538,75359,212711,"86464",0.93,0.645721189783321
"214","Las Vegas--Henderson, NV Urbanized Area (2010)",2090708,1065422,73149,583198,1648620,"47995",0.93,0.646250803702491
"123","Fairfield, CA Urbanized Area (2010)",145455,73893,4852,40339,114232,"28657",0.93,0.646867777855592
"199","Kissimmee, FL Urbanized Area (2010)",361878,183664,12185,99402,283066,"45451",0.93,0.64883808016505
"72","Cheyenne, WY Urbanized Area (2010)",73607,38871,2765,20300,59171,"16237",0.93,0.656926534958003
"115","Elkhart, IN--MI Urbanized Area (2010)",147018,74860,5516,38102,112962,"26794",0.93,0.662700731219348
"318","Rapid City, SD Urbanized Area (2010)",89833,46155,3083,22982,69137,"73396",0.93,0.667587543572906
"280","Norwich--New London, CT--RI Urbanized Area (2010)",204430,113090,8014,55736,168826,"64135",0.93,0.669861277291412
"54","Bridgeport--Stamford, CT--NY Urbanized Area (2010)",948116,513255,37944,244703,757958,"10162",0.93,0.677154934706145
"196","Kenosha, WI--IL Urbanized Area (2010)",124757,66492,4960,31360,97852,"44506",0.93,0.679516003760782
"417","Watsonville, CA Urbanized Area (2010)",82027,41437,3069,19210,60647,"92890",0.93,0.683248965323924
"406","Victoria, TX Urbanized Area (2010)",66694,35819,2373,15652,51471,"90514",0.93,0.695906432748538
"438","Zephyrhills, FL Urbanized Area (2010)",65582,22817,1423,33909,56726,"98182",0.94,0.402231780841237
"362","Sebastian--Vero Beach South--Florida Ridge, FL Urbanized Area (2010)",160489,61102,3393,80044,141146,"80400",0.94,0.432899267425219
"312","Prescott Valley--Prescott, AZ Urbanized Area (2010)",94428,35915,2105,42685,78600,"72112",0.94,0.456933842239186
"292","Palm Coast--Daytona Beach--Port Orange, FL Urbanized Area (2010)",371500,153480,8714,165001,318481,"67134",0.94,0.48191257877236
"281","Ocala, FL Urbanized Area (2010)",161174,65407,3742,67434,132841,"64567",0.94,0.492370578360597
"356","Sarasota--Bradenton, FL Urbanized Area (2010)",711272,305713,18100,308947,614660,"79606",0.94,0.497369277324049
"294","Parkersburg, WV--OH Urbanized Area (2010)",67426,28640,1687,27084,55724,"67672",0.94,0.513961668221951
"96","Davis, CA Urbanized Area (2010)",77174,35921,2033,31285,67206,"22420",0.94,0.534490968068327
"291","Palm Bay--Melbourne, FL Urbanized Area (2010)",484824,218599,12274,189769,408368,"67105",0.94,0.53529904399953
"303","Port Arthur, TX Urbanized Area (2010)",156342,66992,4294,57032,124024,"70993",0.94,0.540153518673805
"419","Weirton--Steubenville, WV--OH--PA Urbanized Area (2010)",70392,32301,1826,27250,59551,"93592",0.94,0.542409027556212
"62","Cape Coral, FL Urbanized Area (2010)",614941,278221,17589,230825,509046,"13510",0.94,0.546553749562908
"130","Florence, AL Urbanized Area (2010)",78660,35967,2174,29207,65174,"29953",0.94,0.55186117163286
"320","Redding, CA Urbanized Area (2010)",119469,54170,3441,41860,96030,"73774",0.94,0.564094553785275
"402","Utica, NY Urbanized Area (2010)",112633,52055,3160,39908,91963,"89785",0.94,0.566042865065298
"98","Decatur, AL Urbanized Area (2010)",67836,30755,1818,22580,53335,"22690",0.94,0.576638230055311
"404","Valdosta, GA Urbanized Area (2010)",80062,37112,2362,27039,64151,"89974",0.94,0.578510077785225
"171","Houma, LA Urbanized Area (2010)",150101,67946,4080,49286,117232,"40375",0.94,0.579585778626996
"94","Daphne--Fairhope, AL Urbanized Area (2010)",70876,32883,1941,23745,56628,"22285",0.94,0.580684467048103
"258","Mobile, AL Urbanized Area (2010)",326444,151987,9588,107171,259158,"57925",0.94,0.586464627756041
"295","Pensacola, FL--AL Urbanized Area (2010)",360619,173731,10290,121646,295377,"68482",0.94,0.58816698659679
"248","Medford, OR Urbanized Area (2010)",164157,77686,4696,54218,131904,"55981",0.94,0.588958636584182
"67","Charleston, WV Urbanized Area (2010)",150524,73575,4366,50334,123909,"15481",0.94,0.593782533956371
"359","Scranton, PA Urbanized Area (2010)",371831,183003,11440,123845,306848,"80227",0.94,0.59639626134112
"17","Anderson, SC Urbanized Area (2010)",81267,39166,2475,26340,65506,"02413",0.94,0.597899429059933
"366","Shreveport, LA Urbanized Area (2010)",302685,141857,9043,95141,236998,"81739",0.94,0.598557793736656
"229","Longview, TX Urbanized Area (2010)",101442,47459,2952,31792,79251,"51256",0.94,0.598844178622352
"35","Battle Creek, MI Urbanized Area (2010)",78093,37327,2280,24942,62269,"05707",0.94,0.599447558175015
"226","Lodi, CA Urbanized Area (2010)",72464,33782,2075,22479,56261,"50851",0.94,0.600451467268623
"427","Wilmington, NC Urbanized Area (2010)",244561,121757,7444,80497,202254,"95833",0.94,0.602000454873575
"301","Pocatello, ID Urbanized Area (2010)",70230,32251,1786,21084,53335,"70426",0.94,0.604687353520203
"117","El Paso, TX--NM Urbanized Area (2010)",816924,375032,21673,243134,618166,"27253",0.94,0.606684935761592
"11","Alton, IL--MO Urbanized Area (2010)",82985,39554,2494,25476,65030,"01765",0.94,0.608242349684761
"385","Tampa--St. Petersburg, FL Urbanized Area (2010)",2663845,1329878,80847,852209,2182087,"86599",0.94,0.609452327061203
"33","Barnstable Town, MA Urbanized Area (2010)",244138,127205,7043,81192,208397,"05167",0.94,0.610397462535449
"371","South Bend, IN--MI Urbanized Area (2010)",287902,138031,8540,87140,225171,"83116",0.94,0.613005227138486
"58","Burlington, NC Urbanized Area (2010)",124840,61490,3480,38308,99798,"11728",0.94,0.616144612116475
"429","Winston-Salem, NC Urbanized Area (2010)",416807,203208,11556,125621,328829,"96670",0.94,0.617974692013174
"79","Coeur d'Alene, ID Urbanized Area (2010)",112254,54258,3223,33482,87740,"18451",0.94,0.618395258718942
"331","Sacramento, CA Urbanized Area (2010)",1846331,898450,57025,553802,1452252,"77068",0.94,0.618659846913621
"97","Dayton, OH Urbanized Area (2010)",727627,362250,22420,221521,583771,"22528",0.94,0.620534421888035
"338","Salem, OR Urbanized Area (2010)",252890,124096,7068,75730,199826,"78229",0.94,0.621020287650256
"80","College Station--Bryan, TX Urbanized Area (2010)",195896,99860,5642,60906,160766,"18748",0.94,0.62115123844594
"383","Syracuse, NY Urbanized Area (2010)",411895,206902,11571,126060,332962,"86302",0.94,0.621398237636727
"235","Lynchburg, VA Urbanized Area (2010)",127601,64183,4010,39095,103278,"52201",0.94,0.621458587501694
"293","Panama City, FL Urbanized Area (2010)",161466,81154,4719,49376,130530,"67294",0.94,0.621726806098215
"261","Montgomery, AL Urbanized Area (2010)",258367,127257,8231,76548,203805,"58600",0.94,0.624405681901818
"27","Auburn, AL Urbanized Area (2010)",84072,43022,2565,25874,68896,"04033",0.94,0.624448444031584
"251","Miami, FL Urbanized Area (2010)",5992775,3069140,181241,1844696,4913836,"56602",0.94,0.624591459706836
"8","Albuquerque, NM Urbanized Area (2010)",766219,383907,22296,228380,612287,"01171",0.94,0.627004982957339
"5","Akron, OH Urbanized Area (2010)",579127,296345,17257,174983,471328,"00766",0.94,0.628744738271437
"352","Santa Cruz, CA Urbanized Area (2010)",170825,91634,5398,53914,145548,"79336",0.94,0.629579245334872
"153","Greenville, SC Urbanized Area (2010)",424337,214079,12778,125548,339627,"35461",0.94,0.630335632914933
"324","Roanoke, VA Urbanized Area (2010)",216746,111140,6850,65090,176230,"75421",0.94,0.630653123758724
"350","Santa Barbara, CA Urbanized Area (2010)",197761,107429,6868,62102,169531,"79282",0.94,0.633683515109331
"204","Lafayette, LA Urbanized Area (2010)",262653,132207,7781,75728,207935,"46045",0.94,0.635809267319114
"391","Toledo, OH--MI Urbanized Area (2010)",500993,253683,16277,145252,398935,"87868",0.94,0.635900585308384
"195","Kennewick--Pasco, WA Urbanized Area (2010)",232954,109215,6624,62340,171555,"44479",0.94,0.636617994229256
"39","Beloit, WI--IL Urbanized Area (2010)",65104,31957,2072,17972,49929,"06760",0.94,0.64004886939454
"313","Providence, RI--MA Urbanized Area (2010)",1206706,635560,37301,357070,992630,"72505",0.94,0.640278855162548
"326","Rochester, NY Urbanized Area (2010)",726102,378485,21415,211816,590301,"75664",0.94,0.641172893151121
"77","Cleveland, OH Urbanized Area (2010)",1754347,913697,58994,510414,1424111,"17668",0.94,0.641591140016473
"10","Allentown, PA--NJ Urbanized Area (2010)",673983,350042,20028,193420,543462,"01495",0.94,0.644096551368817
"151","Greensboro, NC Urbanized Area (2010)",336634,173639,11225,95360,268999,"35164",0.94,0.645500540894204
"298","Philadelphia, PA--NJ--DE--MD Urbanized Area (2010)",5555493,2890190,186069,1584712,4474902,"69076",0.94,0.645866658085473
"277","New York--Newark, NY--NJ--CT Urbanized Area (2010)",18954313,9878282,599766,5414830,15293112,"63217",0.94,0.645930141621928
"43","Birmingham, AL Urbanized Area (2010)",756708,386847,24529,211925,598772,"07786",0.94,0.646067284375355
"232","Los Angeles--Long Beach--Anaheim, CA Urbanized Area (2010)",12615510,6566441,416188,3589320,10155761,"51445",0.94,0.646573014075459
"278","Norman, OK Urbanized Area (2010)",114795,61818,3727,33047,94865,"63433",0.94,0.651641806778053
"34","Baton Rouge, LA Urbanized Area (2010)",626049,320104,20570,171001,491105,"05680",0.94,0.651803585791226
"163","Hartford, CT Urbanized Area (2010)",924956,489740,30134,259857,749597,"37243",0.94,0.653337726805203
"216","Lawton, OK Urbanized Area (2010)",93543,47784,2824,25306,73090,"48394",0.94,0.653769325489123
"287","Orlando, FL Urbanized Area (2010)",1718406,902158,51566,476981,1379139,"65863",0.94,0.654145811263404
"275","New Haven, CT Urbanized Area (2010)",561897,306208,17754,161658,467866,"62407",0.94,0.654477991561687
"344","San Diego, CA Urbanized Area (2010)",3172773,1675874,101849,875428,2551302,"78661",0.94,0.656870100050876
"431","Worcester, MA--CT Urbanized Area (2010)",516888,278513,15472,142289,420802,"97291",0.94,0.661862348562982
"83","Columbia, SC Urbanized Area (2010)",597067,316776,20063,161413,478189,"18964",0.94,0.662449366254765
"188","Joplin, MO Urbanized Area (2010)",83400,44061,2855,22442,66503,"43399",0.94,0.662541539479422
"413","Warner Robins, GA Urbanized Area (2010)",142027,73236,4221,37266,110502,"91783",0.94,0.662757235163164
"349","San Marcos, TX Urbanized Area (2010)",71643,40324,2410,20280,60604,"79201",0.94,0.665368622533166
"396","Tulsa, OK Urbanized Area (2010)",698848,358531,21043,178987,537518,"88948",0.94,0.667012081455877
"73","Chicago, IL--IN Urbanized Area (2010)",8660237,4598167,294222,2280820,6878987,"16264",0.94,0.66843664626783
"351","Santa Clarita, CA Urbanized Area (2010)",266721,141729,8807,70001,211730,"79309",0.94,0.669385538185425
"201","La Crosse, WI--MN Urbanized Area (2010)",104291,57979,3412,28525,86504,"45910",0.94,0.670246462591325
"321","Reno, NV--CA Urbanized Area (2010)",423811,228190,13315,111504,339694,"74179",0.94,0.671751635295295
"14","Ames, IA Urbanized Area (2010)",67745,40699,2422,19778,60477,"02062",0.94,0.672966582337087
"322","Richmond, VA Urbanized Area (2010)",1020577,553701,34121,265857,819558,"74746",0.94,0.675609291837796
"172","Houston, TX Urbanized Area (2010)",5607133,2876167,186126,1377149,4253316,"40429",0.94,0.676217567657799
"32","Baltimore, MD Urbanized Area (2010)",2292343,1245196,69952,594070,1839266,"04843",0.94,0.677007023453921
"2","Aberdeen--Bel Air South--Bel Air North, MD Urbanized Area (2010)",215810,116364,6985,55090,171454,"00199",0.94,0.678689327749717
"220","Leominster--Fitchburg, MA Urbanized Area (2010)",113216,62202,3657,29208,91410,"49096",0.94,0.680472595996062
"81","Colorado Springs, CO Urbanized Area (2010)",612562,325786,18814,152820,478606,"18856",0.94,0.680697692883081
"133","Fort Collins, CO Urbanized Area (2010)",300448,167521,9413,78158,245679,"30628",0.94,0.68186943124972
"76","Clarksville, TN--KY Urbanized Area (2010)",173411,89898,5016,41456,131354,"17317",0.94,0.684394841420893
"109","Dubuque, IA--IL Urbanized Area (2010)",69527,39677,2311,17663,57340,"24823",0.94,0.691960237181723
"221","Lexington-Fayette, KY Urbanized Area (2010)",313293,175258,10709,77760,253018,"49582",0.94,0.692670086713198
"100","DeKalb, IL Urbanized Area (2010)",66819,37892,2266,16239,54131,"22960",0.94,0.700005542110805
"183","Jacksonville, NC Urbanized Area (2010)",106938,57354,3286,24107,81461,"42400",0.94,0.704066976835541
"64","Casper, WY Urbanized Area (2010)",70665,39062,2403,16029,55091,"14482",0.94,0.709045034579151
"253","Midland, TX Urbanized Area (2010)",139531,74024,4401,29647,103671,"57007",0.94,0.714028030982628
"202","Lady Lake--The Villages, FL Urbanized Area (2010)",117276,28201,1271,81833,110034,"45937",0.95,0.25629350927895
"380","State College, PA Urbanized Area (2010)",95549,45959,2443,40903,86862,"84493",0.95,0.529103635651954
"308","Port St. Lucie, FL Urbanized Area (2010)",416124,184171,9527,158610,342781,"71479",0.95,0.537284738652376
"12","Altoona, PA Urbanized Area (2010)",72855,33692,1595,26645,60337,"01792",0.95,0.558397003497025
"140","Gainesville, FL Urbanized Area (2010)",197807,95594,5091,73093,168687,"32167",0.95,0.566694528920427
"116","Elmira, NY Urbanized Area (2010)",68259,31753,1731,23942,55695,"27118",0.95,0.570122991291857
"212","Laredo, TX Urbanized Area (2010)",254988,101227,4635,76110,177337,"47854",0.95,0.570817144758285
"208","Lakeland, FL Urbanized Area (2010)",299918,139703,7065,99676,239379,"46828",0.95,0.583605913634864
"387","Terre Haute, IN Urbanized Area (2010)",93884,44762,2021,31503,76265,"87139",0.95,0.586927161869796
"78","Cleveland, TN Urbanized Area (2010)",70220,33525,1570,22577,56102,"17722",0.95,0.597572279063135
"316","Racine, WI Urbanized Area (2010)",133138,62479,3164,42035,104514,"73153",0.95,0.597805078745431
"159","Hanover, PA Urbanized Area (2010)",67824,32572,1687,21873,54445,"36784",0.95,0.598255119845716
"185","Johnson City, TN Urbanized Area (2010)",126628,63454,3124,42202,105656,"43210",0.95,0.600571666540471
"336","St. Joseph, MO--KS Urbanized Area (2010)",80531,39049,1928,25833,64882,"77743",0.95,0.601846428901698
"71","Chattanooga, TN--GA Urbanized Area (2010)",396541,194581,9127,128646,323227,"15832",0.95,0.601994882853227
"156","Hagerstown, MD--WV--PA Urbanized Area (2010)",191322,91566,4775,60043,151609,"36190",0.95,0.603961506243033
"57","Buffalo, NY Urbanized Area (2010)",931311,468960,22854,298260,767220,"11350",0.95,0.611245796512083
"386","Temple, TX Urbanized Area (2010)",94443,44503,2023,28109,72612,"87058",0.95,0.612887676967994
"53","Bremerton, WA Urbanized Area (2010)",210368,105361,5459,66446,171807,"09946",0.95,0.613252079368128
"373","Spartanburg, SC Urbanized Area (2010)",196426,95557,4459,58649,154206,"83548",0.95,0.619671089322076
"374","Spokane, WA Urbanized Area (2010)",408943,201161,10738,122308,323469,"83764",0.95,0.621886486803991
"377","Springfield, MO Urbanized Area (2010)",284181,143491,6980,86877,230368,"83953",0.95,0.622877309348521
"24","Athens-Clarke County, GA Urbanized Area (2010)",136116,71172,3751,42938,114110,"03763",0.95,0.623713960213829
"273","Newark, OH Urbanized Area (2010)",75217,37877,1788,22775,60652,"61705",0.95,0.62449713117457
"200","Knoxville, TN Urbanized Area (2010)",593182,300969,14150,179964,480933,"45640",0.95,0.625802346688624
"149","Greeley, CO Urbanized Area (2010)",135108,66123,3562,38890,105013,"34786",0.95,0.629664898631598
"95","Davenport, IA--IL Urbanized Area (2010)",284781,142151,6814,83600,225751,"22366",0.95,0.629680488680006
"162","Harrisonburg, VA Urbanized Area (2010)",72688,38434,1830,22387,60821,"37162",0.95,0.631919896088522
"90","Corpus Christi, TX Urbanized Area (2010)",339410,168441,8154,96594,265035,"20287",0.95,0.635542475522101
"311","Poughkeepsie--Newburgh, NY--NJ Urbanized Area (2010)",434846,219476,10586,125310,344786,"71803",0.95,0.636557168794557
"203","Lafayette, IN Urbanized Area (2010)",160754,84121,3808,47533,131654,"46018",0.95,0.638955139988151
"299","Phoenix--Mesa, AZ Urbanized Area (2010)",3994104,1999861,109605,1126979,3126840,"69184",0.95,0.639578935922529
"428","Winchester, VA Urbanized Area (2010)",70819,36853,1802,20697,57550,"96103",0.95,0.640364900086881
"300","Pittsburgh, PA Urbanized Area (2010)",1743372,927672,47102,519905,1447577,"69697",0.95,0.640844666639495
"390","Thousand Oaks, CA Urbanized Area (2010)",221774,115190,5674,64505,179695,"87490",0.95,0.641030635243051
"121","Evansville, IN--KY Urbanized Area (2010)",230451,118374,5534,65720,184094,"28333",0.95,0.643008463067781
"30","Avondale--Goodyear, AZ Urbanized Area (2010)",221256,108467,5595,60101,168568,"04549",0.95,0.6434613924351
"38","Bellingham, WA Urbanized Area (2010)",122026,66583,3587,36855,103438,"06652",0.95,0.643699607494344
"343","San Antonio, TX Urbanized Area (2010)",1979043,988759,54299,537349,1526108,"78580",0.95,0.647895823886645
"393","Tracy, CA Urbanized Area (2010)",92140,46004,2393,24944,70948,"88273",0.95,0.648418560072166
"161","Harrisburg, PA Urbanized Area (2010)",466630,245088,12172,131346,376434,"37081",0.95,0.651078276670014
"52","Bowling Green, KY Urbanized Area (2010)",88041,45806,2193,24541,70347,"09379",0.95,0.651143616643212
"40","Bend, OR Urbanized Area (2010)",100017,53525,2759,28568,82093,"06868",0.95,0.65200443399559
"182","Jacksonville, FL Urbanized Area (2010)",1151103,597176,31473,317891,915067,"42346",0.95,0.652603579847159
"136","Fort Wayne, IN Urbanized Area (2010)",326227,165186,8482,87758,252944,"31087",0.95,0.653053640331457
"7","Albany--Schenectady, NY Urbanized Area (2010)",597692,322555,16951,169536,492091,"00970",0.95,0.655478356645417
"290","Oxnard, CA Urbanized Area (2010)",381540,194383,10484,101034,295417,"66673",0.95,0.657995308326874
"233","Louisville/Jefferson County, KY--IN Urbanized Area (2010)",1000136,526641,28395,273681,800322,"51755",0.95,0.658036390352883
"364","Sheboygan, WI Urbanized Area (2010)",69529,37228,1677,19151,56379,"81118",0.95,0.660316784618386
"158","Hanford, CA Urbanized Area (2010)",90396,45167,2341,23075,68242,"36703",0.95,0.661865127047859
"337","St. Louis, MO--IL Urbanized Area (2010)",2160582,1148415,61287,584322,1732737,"77770",0.95,0.662775135522586
"355","Santa Rosa, CA Urbanized Area (2010)",321359,172331,7833,87525,259856,"79498",0.95,0.663178837510006
"254","Milwaukee, WI Urbanized Area (2010)",1383907,729879,38438,369340,1099219,"57466",0.95,0.663997802075837
"284","Oklahoma City, OK Urbanized Area (2010)",932416,477477,23922,240550,718027,"65080",0.95,0.664984742913567
"184","Janesville, WI Urbanized Area (2010)",69575,36589,1764,18424,55013,"42562",0.95,0.665097340628579
"51","Boulder, CO Urbanized Area (2010)",124622,72903,3656,36626,109529,"09298",0.95,0.665604543089045
"138","Fredericksburg, VA Urbanized Area (2010)",157583,80595,3675,40302,120897,"31600",0.95,0.66664185215514
"270","Napa, CA Urbanized Area (2010)",88611,47965,2369,23600,71565,"61057",0.95,0.670229860965556
"347","San Jose, CA Urbanized Area (2010)",1788846,959925,45920,472297,1432222,"79039",0.95,0.67023478203798
"75","Cincinnati, OH--KY--IN Urbanized Area (2010)",1675232,888903,45919,428350,1317253,"16885",0.95,0.674815695997656
"424","Wichita, KS Urbanized Area (2010)",477761,249569,13407,119517,369086,"95077",0.95,0.676181161030221
"345","San Francisco--Oakland, CA Urbanized Area (2010)",3529790,1983310,89422,945075,2928385,"78904",0.95,0.677270918953621
"354","Santa Maria, CA Urbanized Area (2010)",144103,72803,3607,34599,107402,"79417",0.95,0.677855160983967
"25","Atlanta, GA Urbanized Area (2010)",4970669,2625329,140485,1239220,3864549,"03817",0.95,0.679336450385284
"307","Portland, OR--WA Urbanized Area (2010)",2028282,1112113,53430,523912,1636025,"71317",0.95,0.679765284760319
"228","Longmont, CO Urbanized Area (2010)",97360,51664,2666,24140,75804,"51175",0.95,0.681547147907762
"361","Seattle, WA Urbanized Area (2010)",3387102,1871452,88128,864015,2735467,"80389",0.95,0.684143511875669
"176","Indianapolis, IN Urbanized Area (2010)",1598234,842841,40271,385211,1228052,"41212",0.95,0.686323543302727
"112","Eau Claire, WI Urbanized Area (2010)",107337,59683,2832,27238,86921,"26038",0.95,0.686634990393576
"409","Virginia Beach, VA Urbanized Area (2010)",1473064,807701,43033,367966,1175667,"90892",0.95,0.687015115674762
"111","Durham, NC Urbanized Area (2010)",386855,212708,10630,96704,309412,"25228",0.95,0.687458792807002
"93","Danbury, CT--NY Urbanized Area (2010)",174978,98475,5222,44482,142957,"22096",0.95,0.688843498394622
"50","Boston, MA--NH--RI Urbanized Area (2010)",4406447,2500853,126921,1117445,3618298,"09271",0.95,0.691168333840938
"91","Dallas--Fort Worth--Arlington, TX Urbanized Area (2010)",5690531,3005473,136478,1340179,4345652,"22042",0.95,0.691604619974172
"169","Holland, MI Urbanized Area (2010)",102876,57068,2762,24896,81964,"39430",0.95,0.696256893270216
"194","Kansas City, MO--KS Urbanized Area (2010)",1591885,869495,40030,376005,1245500,"43912",0.95,0.698109193095143
"69","Charlotte, NC--SC Urbanized Area (2010)",1440707,784224,40652,338654,1122878,"15670",0.95,0.698405347686926
"334","St. Cloud, MN Urbanized Area (2010)",114574,65686,3349,28191,93877,"77338",0.95,0.699702802603407
"416","Waterloo, IA Urbanized Area (2010)",115990,65271,3245,28007,93278,"92593",0.95,0.699746992860053
"85","Columbus, OH Urbanized Area (2010)",1493961,821193,41866,346650,1167843,"19234",0.95,0.70317071729676
"325","Rochester, MN Urbanized Area (2010)",113819,63259,3348,26204,89463,"75637",0.95,0.707096788616523
"330","Round Lake Beach--McHenry--Grayslake, IL--WI Urbanized Area (2010)",291309,161276,7698,66723,227999,"76474",0.95,0.707353979622718
"265","Murfreesboro, TN Urbanized Area (2010)",159887,91116,4638,36563,127679,"60733",0.95,0.713633408782964
"257","Missoula, MT Urbanized Area (2010)",85683,52535,2534,20491,73026,"57736",0.95,0.719401309122778
"414","Washington, DC--VA--MD Urbanized Area (2010)",4983485,2854672,138532,1104176,3958848,"92242",0.95,0.721086538306093
"104","Des Moines, IA Urbanized Area (2010)",489754,276499,12776,106262,382761,"23743",0.95,0.722380284302737
"102","Denton--Lewisville, TX Urbanized Area (2010)",415255,235489,11148,87639,323128,"23500",0.95,0.728779307271422
"333","St. Augustine, FL Urbanized Area (2010)",81963,38910,1588,31932,70842,"77230",0.96,0.549250444651478
"134","Fort Smith, AR--OK Urbanized Area (2010)",125332,56252,2229,41231,97483,"30925",0.96,0.577044202578911
"23","Asheville, NC Urbanized Area (2010)",292147,146811,5922,98106,244917,"03358",0.96,0.599431644189664
"89","Conway, AR Urbanized Area (2010)",70869,34525,1452,23008,57533,"19801",0.96,0.600090382910677
"420","Wenatchee, WA Urbanized Area (2010)",73399,34644,1246,22647,57291,"93862",0.96,0.604702309263235
"45","Blacksburg, VA Urbanized Area (2010)",91752,49800,2103,32237,82037,"08002",0.96,0.607043163450638
"70","Charlottesville, VA Urbanized Area (2010)",100888,51340,2161,32655,83995,"15724",0.96,0.611226858741592
"193","Kankakee, IL Urbanized Area (2010)",79883,38847,1737,24530,63377,"43885",0.96,0.612951070577654
"360","Seaside--Monterey, CA Urbanized Area (2010)",113374,56800,2016,35375,92175,"80362",0.96,0.6162191483591
"3","Abilene, TX Urbanized Area (2010)",117690,56943,2179,35238,92181,"00280",0.96,0.617730334884629
"353","Santa Fe, NM Urbanized Area (2010)",93663,49448,2199,28823,78271,"79363",0.96,0.631753778538667
"297","Petaluma, CA Urbanized Area (2010)",67123,35249,1292,20462,55711,"68887",0.96,0.632711672739674
"60","Camarillo, CA Urbanized Area (2010)",74819,39462,1438,22778,62240,"12754",0.96,0.634029562982005
"288","Oshkosh, WI Urbanized Area (2010)",74602,40387,1479,23218,63605,"66160",0.96,0.634965804575112
"13","Amarillo, TX Urbanized Area (2010)",203317,99252,3606,56677,155929,"01927",0.96,0.636520467648738
"224","Little Rock, AR Urbanized Area (2010)",453670,225716,10118,128463,354179,"50392",0.96,0.637293571894438
"234","Lubbock, TX Urbanized Area (2010)",256813,129680,4611,73456,203136,"51877",0.96,0.638390044108381
"392","Topeka, KS Urbanized Area (2010)",148718,74286,3162,41963,116249,"88084",0.96,0.639024851826682
"339","Salinas, CA Urbanized Area (2010)",190450,90988,3752,50999,141987,"78310",0.96,0.640819229929501
"135","Fort Walton Beach--Navarre--Wright, FL Urbanized Area (2010)",206147,107273,3908,59496,166769,"31060",0.96,0.643243048768056
"18","Ann Arbor, MI Urbanized Area (2010)",323077,173848,7349,95143,268991,"02602",0.96,0.646296716247012
"174","Huntsville, AL Urbanized Area (2010)",306102,158061,6702,85150,243211,"40780",0.96,0.649892480192097
"110","Duluth, MN--WI Urbanized Area (2010)",115390,63175,2593,34028,97203,"24850",0.96,0.649928500149172
"86","Concord, CA Urbanized Area (2010)",666866,345969,15466,184692,530661,"19504",0.96,0.651958595035248
"209","Lancaster, PA Urbanized Area (2010)",419373,218837,9220,115806,334643,"47530",0.96,0.653941663205266
"242","Mandeville--Covington, LA Urbanized Area (2010)",99919,50212,2071,26417,76629,"53794",0.96,0.655261063044017
"434","York, PA Urbanized Area (2010)",245052,127541,5453,67084,194625,"97750",0.96,0.655316634553629
"68","Charleston--North Charleston, SC Urbanized Area (2010)",620291,327235,14424,169657,496892,"15508",0.96,0.658563631533613
"342","San Angelo, TX Urbanized Area (2010)",102090,52866,1932,27287,80153,"78553",0.96,0.659563584644368
"88","Conroe--The Woodlands, TX Urbanized Area (2010)",296297,147342,5934,76047,223389,"19755",0.96,0.659575896754093
"372","South Lyon--Howell, MI Urbanized Area (2010)",123210,67138,2409,34411,101549,"83332",0.96,0.661138957547588
"41","Billings, MT Urbanized Area (2010)",117906,61722,2263,31474,93196,"07705",0.96,0.66228164298897
"425","Wichita Falls, TX Urbanized Area (2010)",98470,51354,2263,25827,77181,"95104",0.96,0.665371011000117
"418","Wausau, WI Urbanized Area (2010)",75665,40172,1777,20105,60277,"93025",0.96,0.666456525706323
"192","Kalamazoo, MI Urbanized Area (2010)",222250,118418,5315,59133,177551,"43723",0.96,0.666952030684141
"48","Boise City, ID Urbanized Area (2010)",390045,204897,8339,101892,306789,"08785",0.96,0.667875966869738
"256","Mission Viejo--Lake Forest--San Clemente, CA Urbanized Area (2010)",608874,331980,13844,164922,496902,"57709",0.96,0.668099544779454
"401","Urban Honolulu, HI Urbanized Area (2010)",837906,453140,17605,223169,676309,"89770",0.96,0.670019177624429
"59","Burlington, VT Urbanized Area (2010)",112195,64361,2293,31683,96044,"11755",0.96,0.670119945025197
"245","Marysville, WA Urbanized Area (2010)",156645,83245,3227,39577,122822,"55333",0.96,0.677769454983635
"190","Kahului, HI Urbanized Area (2010)",65687,33553,1191,15559,49112,"43615",0.96,0.683193516859423
"399","Twin Rivers--Hightstown, NJ Urbanized Area (2010)",70902,38042,1632,17342,55384,"89263",0.96,0.68687707641196
"147","Grand Rapids, MI Urbanized Area (2010)",611815,328269,13928,147444,475713,"34300",0.96,0.690056819973387
"412","Waldorf, MD Urbanized Area (2010)",115978,62425,2439,27976,90401,"91261",0.96,0.690534396743399
"314","Provo--Orem, UT Urbanized Area (2010)",543593,263229,11121,117048,380277,"72559",0.96,0.692203314951995
"205","Lafayette--Louisville--Erie, CO Urbanized Area (2010)",97511,51939,2157,23059,74998,"46126",0.96,0.692538467692472
"143","Gilroy--Morgan Hill, CA Urbanized Area (2010)",110039,57719,2451,25622,83341,"33328",0.96,0.692564284085864
"150","Green Bay, WI Urbanized Area (2010)",215416,118125,4328,51746,169871,"34813",0.96,0.695380612347016
"272","Nashville-Davidson, TN Urbanized Area (2010)",1074972,592159,22433,258135,850294,"61273",0.96,0.696416768788207
"241","Manchester, NH Urbanized Area (2010)",163735,93481,4111,40613,134094,"53740",0.96,0.697130371232121
"368","Sioux City, IA--NE--SD Urbanized Area (2010)",105076,55917,2419,24236,80153,"82225",0.96,0.69762828590321
"367","Simi Valley, CA Urbanized Area (2010)",127137,72103,2768,31124,103227,"82144",0.96,0.698489736212425
"310","Pottstown, PA Urbanized Area (2010)",109908,60537,2605,25752,86289,"71749",0.96,0.701561033271912
"178","Iowa City, IA Urbanized Area (2010)",117870,68924,2550,28972,97896,"41590",0.96,0.704053281032933
"65","Cedar Rapids, IA Urbanized Area (2010)",186623,103812,3913,43179,146991,"14752",0.96,0.706247321264567
"286","Omaha, NE--IA Urbanized Area (2010)",774663,421011,16794,173223,594234,"65269",0.96,0.708493623723987
"317","Raleigh, NC Urbanized Area (2010)",1021681,569259,24850,230770,800029,"73261",0.96,0.711547956386581
"103","Denver--Aurora, CO Urbanized Area (2010)",2657289,1495497,60281,606237,2101734,"23527",0.96,0.711553888360754
"219","Lee's Summit, MO Urbanized Area (2010)",89812,48486,2060,19547,68033,"48826",0.96,0.712683550629841
"341","Salt Lake City--West Valley City, UT Urbanized Area (2010)",1102282,597095,21286,233918,831013,"78499",0.96,0.718514632141735
"225","Livermore, CA Urbanized Area (2010)",89475,51508,1939,20117,71625,"50527",0.96,0.719134380453752
"255","Minneapolis--St. Paul, MN--WI Urbanized Area (2010)",2811122,1598483,61779,623156,2221639,"57628",0.96,0.719506184398095
"223","Lincoln, NE Urbanized Area (2010)",278085,160644,5733,62277,222921,"49933",0.96,0.720631972761651
"108","Dover--Rochester, NH--ME Urbanized Area (2010)",92379,55867,2417,21156,77023,"24607",0.96,0.725328797891539
"29","Austin, TX Urbanized Area (2010)",1607497,918603,38778,341457,1260060,"04384",0.96,0.729015284986429
"15","Anchorage, AK Urbanized Area (2010)",258013,148841,6572,54096,202937,"02305",0.96,0.733434514159567
"49","Bonita Springs, FL Urbanized Area (2010)",347888,150214,4619,154819,305033,"08974",0.97,0.492451636380326
"335","St. George, UT Urbanized Area (2010)",115269,49712,1616,37739,87451,"77446",0.97,0.568455477924781
"37","Beaumont, TX Urbanized Area (2010)",148557,67991,1973,46627,114618,"06058",0.97,0.593196531085868
"426","Williamsburg, VA Urbanized Area (2010)",81773,40899,1189,27834,68733,"95411",0.97,0.59504168303435
"411","Waco, TX Urbanized Area (2010)",183087,87066,2921,56932,143998,"91027",0.97,0.604633397686079
"403","Vacaville, CA Urbanized Area (2010)",98354,47963,1617,30592,78555,"89866",0.97,0.610565845585895
"66","Champaign, IL Urbanized Area (2010)",150682,81556,2826,49129,130685,"15211",0.97,0.624065501013888
"168","Hilton Head Island, SC Urbanized Area (2010)",70605,38770,1086,21958,60728,"39079",0.97,0.638420497958108
"82","Columbia, MO Urbanized Area (2010)",131692,70075,2189,38962,109037,"18937",0.97,0.642671753624916
"357","Saratoga Springs, NY Urbanized Area (2010)",67661,36754,1002,19368,56122,"79633",0.97,0.654894693703004
"422","Westminster--Eldersburg, MD Urbanized Area (2010)",66403,36517,1157,18016,54533,"94294",0.97,0.669631232464746
"421","West Bend, WI Urbanized Area (2010)",73085,38654,1236,18991,57645,"93916",0.97,0.670552519732848
"191","Kailua (Honolulu County)--Kaneohe, HI Urbanized Area (2010)",116849,65123,2108,31458,96581,"43669",0.97,0.674283761816506
"246","Mauldin--Simpsonville, SC Urbanized Area (2010)",143181,74421,2076,35383,109804,"55603",0.97,0.677762194455575
"283","Ogden--Layton, UT Urbanized Area (2010)",600468,294491,9227,137819,432310,"64945",0.97,0.681203303185214
"306","Portland, ME Urbanized Area (2010)",213538,123164,3287,55853,179017,"71263",0.97,0.688001698162744
"47","Bloomington--Normal, IL Urbanized Area (2010)",134878,76606,2543,34650,111256,"08407",0.97,0.688556122815848
"237","McKinney, TX Urbanized Area (2010)",230180,117191,3147,52145,169336,"52687",0.97,0.692061936032503
"309","Portsmouth, NH--ME Urbanized Area (2010)",90690,54505,1383,23494,77999,"71506",0.97,0.698791010141156
"271","Nashua, NH--MA Urbanized Area (2010)",229593,134373,4348,53985,188358,"61165",0.97,0.713391520402638
"137","Frederick, MD Urbanized Area (2010)",154380,86392,3011,34442,120834,"31519",0.97,0.714964331231276
"21","Appleton, WI Urbanized Area (2010)",223760,124609,4315,49556,174165,"02764",0.97,0.715465219762869
"227","Logan, UT Urbanized Area (2010)",105847,54650,1518,21678,76328,"50959",0.97,0.715988890053454
"145","Grand Forks, ND--MN Urbanized Area (2010)",67694,39628,1368,15543,55171,"34219",0.97,0.718275905820087
"215","Lawrence, KS Urbanized Area (2010)",96044,58705,1914,22048,80753,"48232",0.97,0.726969895855262
"240","Madison, WI Urbanized Area (2010)",441435,265822,8398,96306,362128,"53200",0.97,0.734055361640083
"125","Fargo, ND--MN Urbanized Area (2010)",199778,118136,3702,41513,159649,"29089",0.97,0.739973316462991
"369","Sioux Falls, SD Urbanized Area (2010)",171906,98501,2654,33743,132244,"82252",0.97,0.744842866216993
"141","Gainesville, GA Urbanized Area (2010)",142202,69459,1672,38786,108245,"32194",0.98,0.641683218624417
"175","Idaho Falls, ID Urbanized Area (2010)",96288,45285,1001,24411,69696,"40996",0.98,0.649750344352617
"127","Fayetteville--Springdale--Rogers, AR--MO Urbanized Area (2010)",347717,173897,3777,91098,264995,"29494",0.98,0.656227475990113
"118","El Paso de Robles (Paso Robles)--Atascadero, CA Urbanized Area (2010)",68324,37169,903,17614,54783,"27261",0.98,0.678476899768176
"44","Bismarck, ND Urbanized Area (2010)",88868,51680,1289,20142,71822,"07921",0.98,0.719556681796664
